Name: Higher Grounds
Number: 2
Gravity: 1800
Acceleration: 2500
Deceleration: 3000
MaxSpeed: 500
JumpForce: 750
Width: 20
Height: 15
####################
#                  #
#                G #
#               ####
#             ###  #
#           ###    #
#         ###      #
#       ###        #
#     ###          #
#   ###            #
# ###              #
#P                 #
#####              #
#                  #
#                  #
####################
